                          NO  ./ruta_a_la_textura_norte                     

SO ./ruta_a_la_textura_sur
WE ./ruta_a_la_textura_oeste
EA                   ./ruta_a_la_textura_este
F    220,100,0
C     225,  30,    0

1111111111111111111111111
1000000000110000000000001
10110N0001110000000000001
100100000000000000000000111111111
111111111011000001110000000000001
100000000011000011101111111111111
11110111111111011100000010001
11110111111111011101010010001
11111111111111111111111111111
11111111111111111111111111111
11000000110101011100000010001
10000000000000001100000010001
10000000000000001101010010001
1100000111010101111101111010111
10110111 1110101 101111010001
11111111 1111111 111111111111