SO ./textures/ibaines.xpm
NO ./textures/jelorria.xpm
WE ./textures/inunez-g.xpm
EA ./textures/sperez-p.xpm

F  0, 0, 0
C 255, 255, 255

        1111111111111111111111111
        1000000000110000000000001
        1011000001110000000000001
        1001000000000000000000001
111111111011000001111000000000001
100000000110000011101111111111111
11110111111111011100000010001
11111111111111011101010010001
11000000110101011100000010001
1000000S0000000011000000100011
10000000000000001101010010001
1100000111010101111101111000111
11110111 1110101 101111010001
11111111 1111111 111111111111